000000000000000000000000000000000000000000000000000000000000000000000000000
000000000000000000000000000000000000000000000000000000000000000000000000000
000000000000000000000000000000000000000000000000000000000000000000000000000
000000000000000000000000000000000000000000000000000000000000000000000000000
000000000000000000000000000000000000000000000000000000000000000000000000000
000000000000000000000000000000000000000000000000000000000000000000000000000
000000000000000000000000000000000000000000000000000000000000000000000000000
000000000000000000000000000000000000000030000000000000000000000000000000000
000000000000000000300000000000000300000000000000000000000000000000000000000
000000000000000003400000000000000000000444000000000000000000000000000000000
000000000000000034400003333300004440000000000000000000000000000000000000000
000000000000000344400003333300000000000000000400000000000000000000000000000
222222222222222222222222222222222222222222222222222222222222222222000022222
111111111111111111111111111111111111111111111111111111111111111111000011111
111111111111111111111111111111111111111111111111111111111111111111000011111